"filename", "language", "Go", "Go Module File", "Markdown", "comment", "blank", "total"
"d:\AdminYSZGB\code\algorithm\README.md", "Markdown", 0, 0, 6, 0, 6, 12
"d:\AdminYSZGB\code\algorithm\books\4-1\main.go", "Go", 16, 0, 0, 2, 4, 22
"d:\AdminYSZGB\code\algorithm\books\4-2\main.go", "Go", 41, 0, 0, 11, 9, 61
"d:\AdminYSZGB\code\algorithm\books\4-3\main.go", "Go", 22, 0, 0, 6, 5, 33
"d:\AdminYSZGB\code\algorithm\books\4-4\main.go", "Go", 52, 0, 0, 8, 12, 72
"d:\AdminYSZGB\code\algorithm\books\4-5\main.go", "Go", 35, 0, 0, 16, 8, 59
"d:\AdminYSZGB\code\algorithm\books\4-6\main.go", "Go", 45, 0, 0, 7, 8, 60
"d:\AdminYSZGB\code\algorithm\books\4-7\main.go", "Go", 60, 0, 0, 10, 9, 79
"d:\AdminYSZGB\code\algorithm\books\4-8\main.go", "Go", 77, 0, 0, 21, 12, 110
"d:\AdminYSZGB\code\algorithm\books\interview1-18\main.go", "Go", 12, 0, 0, 2, 4, 18
"d:\AdminYSZGB\code\algorithm\books\interview1-18\切片反转.md", "Markdown", 0, 0, 0, 0, 1, 1
"d:\AdminYSZGB\code\algorithm\books\interview2-10\main.go", "Go", 1, 0, 0, 19, 5, 25
"d:\AdminYSZGB\code\algorithm\books\interview2-10\接口循环调用.md", "Markdown", 0, 0, 0, 0, 1, 1
"d:\AdminYSZGB\code\algorithm\books\interview2-18\main.go", "Go", 20, 0, 0, 0, 5, 25
"d:\AdminYSZGB\code\algorithm\books\interview2-18\获取结构体信息.md", "Markdown", 0, 0, 0, 0, 1, 1
"d:\AdminYSZGB\code\algorithm\books\interview2-22\main.go", "Go", 24, 0, 0, 6, 6, 36
"d:\AdminYSZGB\code\algorithm\books\interview2-27\main.go", "Go", 17, 0, 0, 1, 4, 22
"d:\AdminYSZGB\code\algorithm\go.mod", "Go Module File", 0, 2, 0, 0, 2, 4
"d:\AdminYSZGB\code\algorithm\main.go", "Go", 4, 0, 0, 1, 4, 9
"d:\AdminYSZGB\code\algorithm\models\array.go", "Go", 100, 0, 0, 20, 10, 130
"d:\AdminYSZGB\code\algorithm\models\hashmap.go", "Go", 27, 0, 0, 6, 5, 38
"d:\AdminYSZGB\code\algorithm\models\heap.go", "Go", 2, 0, 0, 1, 2, 5
"d:\AdminYSZGB\code\algorithm\models\listnode.go", "Go", 115, 0, 0, 34, 21, 170
"d:\AdminYSZGB\code\algorithm\models\queue.go", "Go", 90, 0, 0, 47, 30, 167
"d:\AdminYSZGB\code\algorithm\models\stack.go", "Go", 45, 0, 0, 13, 11, 69
"d:\AdminYSZGB\code\algorithm\models\string.go", "Go", 75, 0, 0, 39, 19, 133
"d:\AdminYSZGB\code\algorithm\models\tree.go", "Go", 119, 0, 0, 71, 27, 217
"Total", "-", 999, 2, 6, 341, 231, 1579